"a" = (/turf/template_noop,/area/template_noop)
"b" = (/obj/machinery/light{dir = 4},/turf/open/floor/mineral/titanium/blue,/area/shuttle/supply)
"c" = (/obj/machinery/light{dir = 8},/obj/effect/turf_decal/delivery,/obj/effect/turf_decal/tile/blue,/obj/effect/turf_decal/tile/blue{dir = 1},/obj/effect/turf_decal/tile/neutral{dir = 4},/obj/effect/turf_decal/tile/neutral{dir = 8},/obj/effect/turf_decal/stripes/line{dir = 8},/turf/open/floor/mineral/titanium,/area/shuttle/supply)
"d" = (/obj/effect/turf_decal/tile/blue,/obj/effect/turf_decal/tile/blue{dir = 1},/obj/effect/turf_decal/tile/neutral{dir = 4},/obj/effect/turf_decal/tile/neutral{dir = 8},/obj/effect/turf_decal/stripes/line{dir = 6},/obj/structure/sign/warning/fire{pixel_x = 32},/turf/open/floor/mineral/titanium,/area/shuttle/supply)
"e" = (/obj/effect/turf_decal/tile/blue,/obj/effect/turf_decal/tile/blue{dir = 1},/obj/effect/turf_decal/tile/neutral{dir = 4},/obj/effect/turf_decal/tile/neutral{dir = 8},/obj/effect/turf_decal/stripes/line,/turf/open/floor/mineral/titanium,/area/shuttle/supply)
"f" = (/obj/effect/turf_decal/tile/blue,/obj/effect/turf_decal/tile/blue{dir = 1},/obj/effect/turf_decal/tile/neutral{dir = 4},/obj/effect/turf_decal/tile/neutral{dir = 8},/obj/effect/turf_decal/stripes/corner{dir = 4},/obj/effect/turf_decal/stripes/corner,/turf/open/floor/mineral/titanium,/area/shuttle/supply)
"g" = (/obj/machinery/conveyor{dir = 4; id = "QMLoad2"},/obj/machinery/door/poddoor{id = "QMLoaddoor2"; name = "supply dock loading door"},/obj/structure/fans/tiny,/turf/open/floor/plating,/area/shuttle/supply)
"h" = (/obj/effect/turf_decal/delivery,/obj/effect/turf_decal/tile/blue,/obj/effect/turf_decal/tile/blue{dir = 1},/obj/effect/turf_decal/tile/neutral{dir = 4},/obj/effect/turf_decal/tile/neutral{dir = 8},/obj/effect/turf_decal/stripes/line{dir = 8},/turf/open/floor/mineral/titanium,/area/shuttle/supply)
"j" = (/obj/structure/shuttle/engine/propulsion/burst/right,/obj/structure/window/reinforced/spawner/east,/turf/open/floor/plating/airless,/area/shuttle/supply)
"k" = (/obj/machinery/light{dir = 1},/obj/effect/turf_decal/tile/blue,/obj/effect/turf_decal/tile/blue{dir = 1},/obj/effect/turf_decal/tile/neutral{dir = 4},/obj/effect/turf_decal/tile/neutral{dir = 8},/obj/effect/turf_decal/stripes/line{dir = 9},/obj/effect/turf_decal/stripes/corner,/turf/open/floor/mineral/titanium,/area/shuttle/supply)
"l" = (/obj/effect/turf_decal/tile/blue,/obj/effect/turf_decal/tile/blue{dir = 1},/obj/effect/turf_decal/tile/neutral{dir = 4},/obj/effect/turf_decal/tile/neutral{dir = 8},/turf/open/floor/mineral/titanium,/area/shuttle/supply)
"m" = (/obj/effect/turf_decal/tile/blue,/obj/effect/turf_decal/tile/blue{dir = 1},/obj/effect/turf_decal/tile/neutral{dir = 4},/obj/effect/turf_decal/tile/neutral{dir = 8},/obj/effect/turf_decal/stripes/end{dir = 4},/turf/open/floor/mineral/titanium,/area/shuttle/supply)
"n" = (/obj/effect/spawner/structure/window/shuttle,/turf/open/floor/plating,/area/shuttle/supply)
"o" = (/obj/machinery/button/door{id = "QMLoaddoor2"; name = "Loading Doors"; pixel_x = 24; pixel_y = 8},/obj/machinery/button/door{id = "QMLoaddoor"; name = "Loading Doors"; pixel_x = 24; pixel_y = -8},/obj/machinery/light{dir = 4},/obj/effect/turf_decal/stripes/line{dir = 4},/obj/effect/turf_decal/tile/blue,/obj/effect/turf_decal/tile/blue{dir = 1},/obj/effect/turf_decal/tile/neutral{dir = 4},/obj/effect/turf_decal/tile/neutral{dir = 8},/turf/open/floor/mineral/titanium,/area/shuttle/supply)
"p" = (/obj/effect/turf_decal/delivery,/obj/effect/turf_decal/tile/blue,/obj/effect/turf_decal/tile/blue{dir = 1},/obj/effect/turf_decal/tile/neutral{dir = 4},/obj/effect/turf_decal/tile/neutral{dir = 8},/obj/effect/turf_decal/stripes/line{dir = 9},/turf/open/floor/mineral/titanium,/area/shuttle/supply)
"q" = (/obj/effect/turf_decal/loading_area/red{dir = 8},/turf/open/floor/mineral/titanium/yellow,/area/shuttle/supply)
"r" = (/obj/effect/turf_decal/delivery,/obj/effect/turf_decal/tile/blue,/obj/effect/turf_decal/tile/blue{dir = 1},/obj/effect/turf_decal/tile/neutral{dir = 4},/obj/effect/turf_decal/tile/neutral{dir = 8},/obj/effect/turf_decal/stripes/line{dir = 10},/obj/machinery/camera{dir = 5},/turf/open/floor/mineral/titanium,/area/shuttle/supply)
"s" = (/obj/effect/turf_decal/tile/blue,/obj/effect/turf_decal/tile/blue{dir = 1},/obj/effect/turf_decal/tile/neutral{dir = 4},/obj/effect/turf_decal/tile/neutral{dir = 8},/obj/effect/turf_decal/stripes/line{dir = 5},/turf/open/floor/mineral/titanium,/area/shuttle/supply)
"u" = (/obj/effect/turf_decal/tile/blue,/obj/effect/turf_decal/tile/blue{dir = 1},/obj/effect/turf_decal/tile/neutral{dir = 4},/obj/effect/turf_decal/tile/neutral{dir = 8},/obj/effect/turf_decal/stripes/line{dir = 6},/turf/open/floor/mineral/titanium,/area/shuttle/supply)
"v" = (/obj/effect/turf_decal/tile/blue,/obj/effect/turf_decal/tile/blue{dir = 1},/obj/effect/turf_decal/tile/neutral{dir = 4},/obj/effect/turf_decal/tile/neutral{dir = 8},/obj/effect/turf_decal/stripes/corner,/turf/open/floor/mineral/titanium,/area/shuttle/supply)
"w" = (/obj/effect/turf_decal/tile/blue,/obj/effect/turf_decal/tile/blue{dir = 1},/obj/effect/turf_decal/tile/neutral{dir = 4},/obj/effect/turf_decal/tile/neutral{dir = 8},/obj/effect/turf_decal/stripes/line{dir = 8},/obj/effect/turf_decal/stripes/corner,/obj/effect/turf_decal/stripes/corner{dir = 4},/turf/open/floor/mineral/titanium,/area/shuttle/supply)
"x" = (/obj/machinery/conveyor{dir = 8; id = "QMLoad"},/obj/machinery/door/poddoor{id = "QMLoaddoor"; name = "supply dock loading door"},/obj/structure/fans/tiny,/turf/open/floor/plating,/area/shuttle/supply)
"z" = (/obj/structure/shuttle/engine/propulsion,/turf/open/floor/plating/airless,/area/shuttle/supply)
"A" = (/obj/structure/fans/tiny,/obj/machinery/door/airlock/titanium{name = "Supply Shuttle Airlock"},/turf/open/floor/mineral/titanium,/area/shuttle/supply)
"B" = (/obj/effect/turf_decal/tile/blue,/obj/effect/turf_decal/tile/blue{dir = 1},/obj/effect/turf_decal/tile/neutral{dir = 4},/obj/effect/turf_decal/tile/neutral{dir = 8},/obj/effect/turf_decal/stripes/line{dir = 8},/obj/effect/turf_decal/stripes/corner{dir = 4},/turf/open/floor/mineral/titanium,/area/shuttle/supply)
"C" = (/obj/effect/turf_decal/tile/blue,/obj/effect/turf_decal/tile/blue{dir = 1},/obj/effect/turf_decal/tile/neutral{dir = 4},/obj/effect/turf_decal/tile/neutral{dir = 8},/obj/effect/turf_decal/stripes/corner,/obj/effect/turf_decal/stripes/corner{dir = 4},/turf/open/floor/mineral/titanium,/area/shuttle/supply)
"D" = (/obj/effect/turf_decal/loading_area/red{dir = 4},/turf/open/floor/mineral/titanium/yellow,/area/shuttle/supply)
"E" = (/obj/effect/turf_decal/tile/blue,/obj/effect/turf_decal/tile/blue{dir = 1},/obj/effect/turf_decal/tile/neutral{dir = 4},/obj/effect/turf_decal/tile/neutral{dir = 8},/obj/effect/turf_decal/stripes/line{dir = 4},/turf/open/floor/mineral/titanium,/area/shuttle/supply)
"F" = (/turf/closed/wall/mineral/titanium,/area/shuttle/supply)
"H" = (/obj/effect/turf_decal/tile/blue,/obj/effect/turf_decal/tile/blue{dir = 1},/obj/effect/turf_decal/tile/neutral{dir = 4},/obj/effect/turf_decal/tile/neutral{dir = 8},/obj/effect/turf_decal/stripes/line{dir = 1},/turf/open/floor/mineral/titanium,/area/shuttle/supply)
"I" = (/turf/closed/wall/mineral/titanium/nodiagonal,/area/shuttle/supply)
"J" = (/obj/structure/chair/comfy/shuttle{dir = 1},/obj/machinery/camera{dir = 1},/turf/open/floor/mineral/titanium/blue,/area/shuttle/supply)
"M" = (/obj/structure/shuttle/engine/heater,/obj/structure/window/reinforced/spawner/west,/obj/structure/window/reinforced/spawner/north,/turf/open/floor/engine,/area/shuttle/supply)
"N" = (/obj/effect/turf_decal/tile/blue,/obj/effect/turf_decal/tile/blue{dir = 1},/obj/effect/turf_decal/tile/neutral{dir = 4},/obj/effect/turf_decal/tile/neutral{dir = 8},/obj/effect/turf_decal/stripes/line{dir = 10},/obj/structure/sign/warning/fire{pixel_x = -32},/turf/open/floor/mineral/titanium,/area/shuttle/supply)
"O" = (/obj/machinery/computer/security,/turf/open/floor/mineral/titanium/blue,/area/shuttle/supply)
"P" = (/obj/effect/turf_decal/tile/blue,/obj/effect/turf_decal/tile/blue{dir = 1},/obj/effect/turf_decal/tile/neutral{dir = 4},/obj/effect/turf_decal/tile/neutral{dir = 8},/obj/effect/turf_decal/stripes/corner{dir = 8},/turf/open/floor/mineral/titanium,/area/shuttle/supply)
"Q" = (/obj/effect/turf_decal/tile/blue,/obj/effect/turf_decal/tile/blue{dir = 1},/obj/effect/turf_decal/tile/neutral{dir = 8},/obj/effect/turf_decal/tile/neutral{dir = 4},/obj/effect/turf_decal/stripes/end{dir = 4},/turf/open/floor/mineral/titanium,/area/shuttle/supply)
"R" = (/obj/machinery/computer,/turf/open/floor/mineral/titanium/blue,/area/shuttle/supply)
"S" = (/obj/structure/shuttle/engine/propulsion/burst/left,/obj/structure/window/reinforced/spawner/west,/turf/open/floor/plating/airless,/area/shuttle/supply)
"T" = (/obj/docking_port/mobile/supply,/obj/structure/fans/tiny,/obj/machinery/door/airlock/titanium{name = "Supply Shuttle Airlock"},/turf/open/floor/mineral/titanium,/area/shuttle/supply)
"U" = (/turf/closed/wall/mineral/titanium/interior,/area/shuttle/supply)
"V" = (/obj/machinery/door/airlock/titanium{name = "Supply Shuttle Bridge Airlock"},/turf/open/floor/mineral/titanium/blue,/area/shuttle/supply)
"W" = (/obj/structure/shuttle/engine/heater,/obj/structure/window/reinforced/spawner/north,/turf/open/floor/engine,/area/shuttle/supply)
"X" = (/obj/structure/shuttle/engine/heater,/obj/structure/window/reinforced/spawner/east,/obj/structure/window/reinforced/spawner/north,/turf/open/floor/engine,/area/shuttle/supply)
"Y" = (/obj/effect/turf_decal/tile/blue,/obj/effect/turf_decal/tile/blue{dir = 1},/obj/effect/turf_decal/tile/neutral{dir = 4},/obj/effect/turf_decal/tile/neutral{dir = 8},/obj/effect/turf_decal/stripes/line{dir = 8},/turf/open/floor/mineral/titanium,/area/shuttle/supply)
"Z" = (/obj/structure/sign/nanotrasen{pixel_x = -32; pixel_y = 32},/obj/effect/turf_decal/tile/blue,/obj/effect/turf_decal/tile/blue{dir = 1},/obj/effect/turf_decal/tile/neutral{dir = 8},/obj/effect/turf_decal/tile/neutral{dir = 4},/obj/effect/turf_decal/tile/neutral{dir = 8},/obj/effect/turf_decal/stripes/corner{dir = 1},/turf/open/floor/mineral/titanium,/area/shuttle/supply)

(1,1,1) = {"
FnnFFFF
FROIkmF
FJbIwDg
FIVIBsA
FpHHZoF
FcllvuT
Fhllfqx
FrPlCQF
UUYlEUF
MUNedUX
SFWWWFj
azzzzza
"}
